#######################
#S#     #       #     #
# # ### # ### ##### # #
# #   #   # #     # # #
# ### ### # # ### # ###
#     #   #   #   #   #
##### # ######### ### #
#     #       #     # #
# ####### ### # ### # #
#         #   #   #   E
#######################
